border_size=1
usage=map

Wo          , Wo          , Wo          , Wo          , Wo          , Wo          , Wo          , Ww          , Ww          , Gs^Fdf      , Gs^Fdf      , Ww          , Ss          , Gg          , Gg          , Gg          , Gs^Fdf      
Wo          , Wo          , Wo          , Wo          , Wo          , Wo          , Ww          , Ww          , Ww^Bw\      , Ds          , Gg          , Gg          , Gg          , Gg          , Re^Gvs      , Re^Gvs      , Re^Gvs      
Wo          , Wo          , Wo          , Wo          , Wo          , Ww          , Ww          , Ww          , Ds          , Ds          , Gg^Vh       , Gg          , Gg          , Re^Gvs      , Gg          , Re^Gvs      , Gg          
Wo          , Wo          , Wo          , Wo          , Ww          , Ww          , Ww          , Ww^Bw\      , Ds          , Gg          , Gg          , Gg          , Gg          , Gg          , Ce          , Gg          , Gg          
Wo          , Wo          , Wo          , Wo          , Ww          , Ww^Bw\      , Ds          , Ds          , Gg          , Ch          , Gg          , Ww          , Gg^Vh       , Gg          , Rr          , Re          , Re          
Wo          , Wo          , Ww          , Ww          , Ww^Bw\      , Ww          , Ds          , Gg          , Ch          , 1 Kh        , Ch          , Gg          , Rr          , Rr          , Ce          , Re          , Gg          
Wo          , Wo          , Ww          , Ww          , Ds          , Ds          , Gg          , Gg          , Gg          , Gg          , Rr          , Rr          , Gg          , Gg          , Gg          , Gg          , Gg          
Ww          , Ww          , Ww          , Gg          , Gg          , Gg          , Gg          , Gg^Vh       , Rr          , Gg          , Rr          , Gg^Vh       , Gg          , Gg          , Re^Gvs      , Re^Gvs      , Re^Gvs      
Ww          , Ww          , Ds          , Gg          , Gg          , Ce          , Rr          , Rr          , Gg          , Rr          , Gg          , Gg          , Gg          , Re^Gvs      , Re^Gvs      , Re^Gvs      , Gg          
Ww          , Ww          , Ds          , Gg          , Gg          , Re          , Re          , Ce          , Gg          , Gg          , Gg          , Gg          , Re^Gvs      , Gg          , Gg          , Gg          , Gs^Fmf      
Ww          , Ds          , Gg          , Gg          , Gg          , Re          , Gg          , Gg          , Gg          , Gg          , Re^Gvs      , Re^Gvs      , Re^Gvs      , Re^Gvs      , Gg          , Gs^Fmf      , Gs^Fmf      
